44444555555544444333322222222333
33344445555544444433332222223334
33333444555554444443333222333444
22233344455555444443333333334445
12222334444555444444333333344455
11112233444455444444333333344455
01111223344444444443333333344455
00001122334444444443333333344455
00001112233444444433333333344455
00000112233444444333333333334444
10000112233344443333322223333444
11111112223334433333222222333344
21111112233333333333222222233334
22211222233333333333222222233333
32222222333334433333222222223333
33322223333444443333222222233333
43333333334444444333322222233333
44333333344444444333332222333333
44443334444444444433333223333334
54444444444444444433333222333333
54444444444444444443333222233333
55444444444444444433332222222333
55444444444444444433322222222233
55444444444444444433322211122223
54444444444444444333222111111222
44443333444444443333221111111122
44333333334444443332211100011122
43333333334444433332211000001122
43333233333444433332211000001122
33322223333444433332211000001122
33322223333444443332211000011122
33322223333444443332211100111223