00000000000000000000000000000000
00000000000000000000000000000000
00000000000000000000000000000000
00000000000000000000000000000000
00000000000000000000000000000000
00000001111110000000000000000000
00000001222210000000000000000000
00000001111211100000000000000000
01111100121222100000000000000000
01222111121222100000000000000000
01222221121222100000000000000000
01222121121121111110000000000000
01111121222122222210000000000000
00000122222121111110000000000000
00000121222122221000000000000000
00001121111122221000000000000000
00001222222222221000000000000000
00001111111122221111111100000000
00000000111112111222222100000000
00000000122222111211111100000000
00001111121112122222221000000000
00001222221012122211121100000000
00001112111012222212222100000000
00001222210012122212222100000000
00001222210011121112222100000000
00001222210000121012222100000000
00111111211111121011111100000000
00122222211222121000000000000000
00111111111222121000000000000000
00000000001222221000000000000000
00000000001222121000000000000000
00000000001111111000000000000000